Md, Md, Md, Gll^Fmf, Hhd^Fmf, Gll^Fmf, Gll^Fmf, Gll^Fmf, Gll^Fmf, Gg, Gll^Fmf, Gll^Fmf, Hhd^Fmf, Gll^Fmf, Gll^Fmf, Ss, Wwf, Gg, Gll^Fmf, Hhd, Hhd^Fmf, Gll^Fmf, Gll^Fmf, Gll^Fmf, Gll^Fmf, Gll^Fmf, Gll^Fmf, Gg, Mm, Mm, Mm^Xm, Mm^Xm, Mm^Xm, Mm^Xm, Mm, Mm, Mm^Xm, Mm, Mm^Xm, Mm, Mm, Mm, Rp, Hhd, Mm, Mm
Md, Md, Hhd^Fmf, Hhd^Fmf, Gll^Fmf, Gll^Fmf, Gll^Fmf, Gll^Fmf, Gll^Fmf, Gll^Fmf, Gll^Fmf, Hhd^Fmf, Hhd^Fmf, Gll^Fmf, Gll^Fmf, Wwf, Ss, Gll^Fmf, Gll^Fmf, Hhd^Fmf, Hhd^Fmf, Gll^Fmf, Gll^Fmf, Gll^Fmf, Hhd^Fmf, Gll^Fmf, Hhd^Fmf, Mm, Mm, Mm^Xm, Mm^Xm, Mm^Xm, Mm, Mm, Hhd, Mm, Mm, Mm, Mm, Mm^Xm, Mm, Hhd, Rp^Qov, Hhd, Mm, Mm
Hhd^Fmf, Hhd, Hhd^Vht, Hhd^Fmf, Gll^Fmf, Gll^Fmf, Gll^Fmf, Gll^Fmf, Gll^Fmf, Gll^Fmf, Gll^Fmf, Hhd^Fmf, Gll^Fmf, Gll^Fmf, Gll^Fmf, Wwf, Wwg, Gll^Fmf, Gll^Fmf, Hhd^Fmf, Hhd^Fmf, Gll^Fmf, Gll^Fmf, Hhd^Fmf, Hhd^Fmf, Hhd^Fmf, Mm, Mm, Mm, Mm, Mm, Mm, Hhd, Mm, Hhd, Hhd, Chr, 1 Khr^Vov, Chr, Mm, Gd, Rp, Mm, Mm, Mm^Xm, Mm
Hhd^Fmf, Hhd^Fmf, Hhd^Fmf, Gll^Fmf, Gll^Fmf, Gll^Fmf, Gll^Fmf, Gll^Fmf, Gll^Fmf, Gll^Fmf, 4 Gll^Vct, Gll^Fmf, Gll^Fmf, Gll^Fmf, Gll^Fmf, Gll^Fmf, Gll^Fmf, Wwg, Wwg, Gll^Fmf, Gll^Fmf, Gll^Fmf, Gll^Fmf, Gll^Fmf, Gll^Fmf, Gll^Fmf, Mm, Mm, Mm, Mm, Mm, Hhd, Hhd^Vhhr, Hhd, Gd, Gd, Chr, Gd, Chr, Gd, Rp, Rp, Mm, Mm^Xm, Mm^Xm, Mm^Xm
Gll^Fmf, Gll^Fmf, Gll^Fmf, Gll^Fmf, Hhd^Fmf, Gll^Fmf, Hhd^Fmf, Hhd^Fmf, Hhd^Fmf, Gll^Fmf, Gll^Fmf, Gll^Fmf, Gll^Ecf, Gll^Fmf, Gll^Fmf, Gll^Fmf, Gll^Fmf, Ss, Wwg, Gll^Fmf, Gll^Fmf, Gll^Fmf, Gll^Fmf, Gll^Fmf, Gll^Fmf, Hhd^Fmf, Hhd^Fmf, Mm, Mm, Mm, Hhd, Hhd, Hhd, Gd, Gd^Esd, Gd^Esd, Gd^Esd, Gd, Rp, Rp, Gll^Fmf, Hhd, Mm, Mm, Mm^Xm, Wo
Gll^Fmf, Gll^Fmf, Gll^Fmf, Hhd^Fmf, Hhd^Fmf, Hhd^Fmf, Md, Md, Hhd^Fmf, Hhd^Fmf, Gll^Fmf, Gll^Fmf, Gll, Gll^Vct, Gll^Fmf, Gll^Fmf, Gll^Fmf, Ss, Wwg, Wwg, Gll^Fmf, Gll^Fmf, Gll^Fmf, Gll^Fmf, Gll^Fmf, Hhd^Fmf, Hhd^Vht, Hhd^Fmf, Hhd^Fmf, Hhd^Fmf, Hhd^Fmf, Hhd, Gll, Gll, Gll^Dr, Gd^Esd, Gll^Esd, Rp, Gd^Vo, Gll, Gll^Fmf, Hhd^Fmf, Wwg, Wwg, Wo, Wo
Gll^Fmf, Gll^Fmf, Gll^Fmf, Gll^Fmf, Gll^Fmf, Gll^Fmf, Hhd^Fmf, Hhd^Fmf, Hhd^Fmf, Hhd^Fmf, Gll^Fmf, Gll^Fmf, Gll^Fmf, Gll^Fmf, Gll^Fmf, Gll^Fmf, Gll^Fmf, Gll^Fmf, Wwg, Wwg, Gll^Fmf, Gll^Fmf, Gll^Fmf, Gll, Gll^Fmf, Hhd^Fmf, Hhd^Fmf, Hhd^Fmf, Hhd^Fmf, Hhd, Hhd, Hhd, Gll, Gll^Fmf, Gll, Gll, Rp, Rp, Gll, Gll, Wwg, Wwg, Mm, Mm, Mm, Mm^Xm
Gll^Fmf, Gll^Fmf, Gll^Fmf, Gll^Fmf, Gll^Fmf, Gll^Fmf, Gll^Fmf, Gll^Fmf, Gll^Fmf, Gll^Fmf, Gll^Fmf, Gll^Fmf, Gll^Fmf, Gll^Fmf, Gll^Fmf, Gll^Fmf, Gll^Fmf, Gs, Wwg, Ss, Gs, Gll^Fmf, Gll, Gll, Gll, Gll^Fmf, Gll^Fmf, Hhd^Fmf, Gll^Fmf, Hhd, Gd, Gd, Gs, Gll, Rp, Rp, Gll^Fmf, Gll, Wwg, Wwg, Gs, Hhd, Hhd, Mm, Mm, Mm
Gll^Fmf, Gll^Fmf, Re^Vo, Gll, Gll^Fmf, Gll^Fmf, Gll^Fmf, Gll^Fmf, Gll^Fmf, Gll^Fmf, Gll^Fmf, Gll^Fmf, Gll^Fmf, Gll^Fmf, Gll^Fmf, Gll^Fmf, Gll, Gs, Wwf, Gs, Ds, Ds, Ds, Gll, Gs, Gll, Ss, Gll^Fmf, Ds, Gll, Gs, Gs, Wwf, Rp, Wwf, Wwf, Wwg, Wwg, Gs, Gs, Gll, Gd, Hhd^Fdf, Mm, Mm, Mm
Gll^Fmf, Gll^Fmf, Gll^Fmf, Gll^Fmf, Gll^Fmf, Gll^Fmf, Gll^Fmf, Gll^Fmf, Gll^Fmf, Gll^Fmf, Gll, Gll^Fmf, Gll^Fmf, Gll^Fmf, Gll^Fmf, Gll^Fmf, Gll, Gs, Gs, Wwg, Wwg, Wwg, Wwg, Wwg, Wwg, Wwg, Wwg, Wwg, Wwg, Ds, Wwg, Wwf, Gs, Wwg^Bsb|, Gd, Gd, Gd, Gs, Gll^Fdf, Gll^Fdf, Gll^Fdf, Gll^Fdf, Gll^Fdf, Hhd^Fdf, Hhd, Hhd
Gll^Fmf, Gll^Fmf, Gll^Fmf, Gll^Fmf, Gll^Fmf, Gll^Fmf, Gll, Gll^Fmf, Gll^Eff, Gll, Gll, Gll^Fmf, Gll^Fmf, Gll^Fmf, Gll^Fmf, Gll^Fmf, Gll, Gd, Gs, Ss, Ss, Ss, Wwg, Ss^Vhs, Gs, Gs, Hhd, Gs, Hhd^Fdf, Wwg, Gs, Gs, Rp, Rp, Gd, Gd, Gd, Gd, Gd, Gll^Fdf, Gll^Fdf, Gll^Fdf, Gll, Hhd, Hhd, Hhd
Gll^Fmf, Gll^Fmf, Hhd^Fmf, Hhd^Fmf, Hhd, Gll, Gll^Eff, Gll^Eff, Rb^Gvs, Gd^Vh, Gd, Gll, Gll, Gll^Fmf, Gll, Gll, Gd, Gd, Gs, Gs, Wwg, Wwg, Gs, Gs, Gd, Gd, Hhd, Hhd^Fdf, Gd, Hhd, Rr, Rp, Gd, Gd, Gd, Gd, Gd^Vhr, Gd, Gd, Gd, Gd, Gll^Fdf, Gll, Gll, Hhd, Hhd
Hhd^Fmf, Hhd^Fmf, Hhd^Fmf, Hhd^Fmf, Hhd, Hhd, Gd, Rb^Gvs, Rb^Gvs, Rb^Gvs, Gd, Gd, Gd, Gd, Gd, Gd, Gd, Gd, Gs, Wwf, Gs, Gs, Gd, Gg^Fdf, Gg^Fdf, Gd, Gd, Gd, Rr, Rr, Gd, Gd, Gd, Gd, Gd, Gd, Gd, Gd, Gd, Gd, Gd, Gll, Hhd, Hhd, Hhd, Hhd
Hhd, Hhd^Fmf, Gll^Fmf, Gll^Fmf, Gll, Gd, Gd, Gd, Gd, Gd, Gd, Gd, Gd, Re, Re, Re, Re, Gs, Wwg, Wwf, Gs, Gd, Gg^Fdf, Gg^Fdf, Gd, Gd, Rr, Rr, Rb^Gvs, Gs^Vh, Rb^Gvs, Rb^Gvs, Hhd, Hhd^Fdf, Hhd^Fdf, Hhd, Gd, Gd, Gd, Gd, Gd, Gd, Gd, Gd, Gd, Gg
Hhd, Gll, Gll, Gll, Gd, Gd, Gd, Gd, Gd, Gd, Gll^Fdf, Gll, Gll, Gd, Gd, Gd, Gs, Re, Wwg, Gs, Gs, Gd, Gd, Gd, Rr, Rr, Gd, Gd, Gd, Rb^Gvs, Rb^Gvs, Rb^Gvs, Gd, Hhd, Hhd, Hhd^Fdf, Hhd, Gd, Gd, Gd, Gll^Fdf, Gd, Gd, Gd, Gd, Gd
Gd, Gd, Gd, Gd, Gd, Gd, Gd, Gd, Gd, Gll^Fdf, Gll, Gll^Fdf, Gll^Fdf, Gd, Gd, Gd, Gs, Wwf, Re, Gs, Gs, Gs, Rr, Rr, Gd, Gd, Hhd, Gd, Gd, Gd, Gd, Gll^Fmf, Gd, Gd, Hhd, Hhd, Gd, Gd, Gd, Gd, Gll^Fdf, Gd, Gd, Gd, Gd, Gd
Gd, Gd, Rb^Gvs, Gd^Vh, Gd, Gd, Gd, Gd, Gd, Gd, Gd, Gll, Gd, Gd^Wm, Gs, Gs, Wwg, Wwg, Ce, 2 Rrc^Vhc, Ce, Rr, Gd, Gd, Gd, Gd, Gd, Hhd, Gd, Gd, Gd, Gd, Gd, Gd, Gd, Gd, Gd, Gd, Gd, Gll^Fdf, Gll^Fdf, Gll^Fdf, Gd, Gd, Gd, Gd
Gll^Fmf, Rb^Gvs, Rb^Gvs, Rb^Gvs, Gd, Gd, Gd, Gd, Rb^Gvs, Gs^Vh, Rb^Gvs, Gd, Gd, Gd, Gs, Ds, Wwg, Gs, Ce, Rrc^Kov, Ce, Gs, Gd, Gd, Gd, Gd, Gd, Gd, Gll, Gd, Gll^Fdf, Gd, Gd, Gd, Gd, Gd, Gd, Gd, Gd, Gll^Fdf, Gd, Gd, Gd, Gd, Gd, Gd
Gll^Fmf, Gd, Gll, Gd, Gll, Gll^Fdf, Gd, Gd, Gd, Rb^Gvs, Gd, Gd, Gd, Gd, Gs, Ds, Wwg^Bsb/, Rr, Gs, Ce, Gs, Gs, Gd, Gd, Ss, Gd, Gd, Gd, Gll^Fmf, Gll^Fdf, Gll^Fmf, Gll^Fdf, Gll^Fdf, Gd, Gd, Gd, Gd^Eff, Gd^Eff, Gd^Eff, Gd^Eff, Gd^Eff, Gd, Gd, Gd, Gd, Gd
Gll^Fmf, Gll^Fdf, Gll^Fdf, Gll, Gll^Fdf, Gll^Fdf, Gll^Fdf, Gd, Gll^Fdf, Gd, Gd, Gd, Gd, Gd, Rr, Rr, Ds, Wwg, Wwg, Gs, Gs, Gs, Sm, Ss, Sm, Ss, Gs, Gll^Fmf, Gll, Gll^Fmf, Gll^Fdf, Gll^Fdf, Gd, Gd, Gd, Gd^Eff, Rb^Gvs, Rb^Gvs, Rb^Gvs, Rb^Gvs, Gd, Gd, Gd, Gd, Gd, Gd
Gll^Fmf, Gll^Fmf, Gll^Fmf, Gll^Fdf, Gll, Gll^Fdf, Gll, Gll^Fdf, Gd, Gd, Gd, Gd, Rr, Rr, Gd, Gs, Gs, Ds, Ds, Wwg, Wwg, Wwg, Wwg, Ss, Wwg, Sm, Sm, Gs, Gs, Gd, Gd, Gd, Gd, Gd, Gd, Gd, Gs^Vh, Rb^Gvs, Gd, Gd, Gd, Gd, Gd, Gd, Gll^Fdf, Gll^Fdf
Hhd, Gll^Fmf, Gll, Gll, Hhd, Gll, Gll, Gll, Gd, Gd, Gd, Gd, Rr, Gd, Rb^Gvs, Gd, Gd, Gs, Gs, Ss, Wwg^Ewl, Wwg^Ewl, Wwg, Wwg, Wwg^Ewf, Wwg, Wwf, Ds, Gs, Gd, Gd, Gd, Gd, Gd, Gd, Gd, Hhd, Gd, Gd, Gd, Gd, Gd, Gll, Gll, Gll^Fdf, Gll^Fdf
Hhd, Gll, Hhd, Gll, Hhd, Gll, Gd, Gd, Gd, Gll^Fdf, Gd, Gd, Rr, Rb^Gvs, Rb^Gvs, Rb^Gvs, Hhd, Gd, Gs, Ss, Wwg, Wwg^Ewl, Wwg, Wwg^Ewl, Wwg, Wwg, Ds, Ds, Gs, Gd, Gd, Gd, Gd, Gd, Gd, Hhd, Gd, Hhd, Gd, Gd, Gd, Gd, Gll^Fdf, Gll^Fdf, Gll^Fdf, Gll^Fdf
Hhd, Hhd, Hhd, Hhd, Hhd, Gd, Gd, Gd, Gd, Gll^Fdf, Gd, Gd, Rr, Gd^Vh, Gd, Hhd, Gd, Gd, Gs, Wwg^Ewl, Wwg, Wwg, Ds, Wwg, Ds, Ds, Gd, Gs, Gll, Gd, Gd, Gd, Gd, Gd, Gd, Gd, Gd, Gd, Gd, Gd, Gd, Gd, Gll, Gll^Fdf, Gll^Fdf, Gll^Fdf
Hhd, Hhd, Hhd, Hhd, Hhd, Gd, Gd, Gd, Gd, Gd, Gd, Gd, Rr, Gd, Hhd, Hhd, Gd, Gd, Gs, Wwg, Wwf, Wwf, Ds, Ds, Gd, Gd, Gd, Gd, Gll^Fdf, Gll^Fdf, Gd, Gd, Gd, Gd, Gd, Gd, Gd, Gd, Gd, Gd, Gd, Gd, Gd, Gll, Gll^Fdf, Gll^Fdf
Hhd, Hhd, Hhd^Fdf, Hhd, Gd, Gd, Gd, Gd, Gd, Gd, Gd, Gd, Rr, Gd, Hhd, Hhd, Gd, Gd, Gs, Ds, Ds, Ds, Gd, Gd, Gd, Gd, Gd, Gd, Gll^Fdf, Gll, Hhd, Gd, Gd, Gd, Gd, Gd, Gd, Gd, Gd, Gd, Gd, Gd, Gd, Gll^Fdf, Gll^Fdf, Gll^Fdf
Hhd, Hhd^Fdf, Hhd, Gd, Gd, Gd, Gd, Gd, Gd, Gd, Gd, Gd, Rr, Gd, Gd, Gd, Gd, Gd, Gd, Gs, Gd, Gd, Gd, Gd, Gd, Gd, Gd, Gd, Gd, Gll^Fdf, Gll^Fmf, Gll^Fdf, Gll^Fdf, Gd, Gd, Gd, Gd, Gd, Gd, Gd, Gd^Vhr, Gd, Gd, Gd, Gd, Gll^Fdf
Hhd, Hhd^Fdf, Gll, Gll, Gll^Fdf, Gll, Gd, Gd, Gd, Gd, Gd, Gd, Rr, Gd, Gd, Gd, Gd, Gd, Gd, Gd, Gd, Gd, Gd, Gd, Gd, Gd, Gd, Gd, Gd, Gll^Fdf, Gll^Fdf, Gll^Fmf, Gd, Gd, Gd, Gd, Gd, Gd, Gd, Gd, Gd, Gd, Gd, Gd, Gd, Gd
Hhd, Hhd^Fdf, Gll^Fdf, Gll^Fdf, Gll^Fmf, Gll^Fdf, Gll^Fdf, Gd, Gd, Gd, Rr, Rr, Gd, Gd, Gd, Gd, Gll, Gll, Gll, Gd, Gd, Gd, Gd, Gd, Gd^Vhr, Gd, Gd, Gd, Gd, Gd, Gd, Gd, Gd, Gd, Gd, Gd, Gd, Gd, Gd, Gd, Gd, Gd, Gd, Gd, Gd, Gd
Hhd, Gll, Gll, Gll^Fdf, Gll^Fdf, Gll^Fdf, Gd, Gd, Gd, Gd, Rr, Gd, Gd, Gd, Gd, Gll, Gll^Fdf, Gll^Fdf, Gll^Fdf, Gll^Fdf, Gd, Gd, Gd, Gd, Gd, Gd, Gd, Gd, Gd, Gd, Gd, Gd, Gd, Gd, Gd, Gd, Gd, Gd, Gd, Gd, Gd, Gd, Gd, Gd, Hhd, Gd
Gd, Gd, Gd, Gll^Fdf, Gd, Gd, Gd, Gd, Gd, Rr, Gd, Gd, Gd, Gd, Gll^Fdf, Gll^Fdf, Gll^Fdf, Gll^Fdf, Gll^Fdf, Gll, Gd, Gd, Gd, Gd, Gd, Gd, Gll^Fdf, Gd, Gd, Gd, Gd, Gd^Vhr, Gd, Gd, Gd, Gd, Gd, Gd, Gd, Gd, Gd, Gd, Gd, Gd, Hhd, Hhd
Gd, Gd, Gd, Gd, Gd, Gd, Gd, Gd, Rr, Rr, Gd, Gd, Gd, Gd, Gll^Fdf, Gll^Fdf, Gll^Fdf, Gll^Fdf, Gd, Gd, Gd, Gd, Gd, Gd, Hhd, Hhd^Fdf, Hhd^Fdf, Hhd, Gd, Gd, Gd, Gd, Gd, Gd, Gd, Gd, Gd, Gd, Gd, Gd, Hhd, Gd, Gd, Hhd, Hhd, Hhd
Gd, Gd, Gd, Gd, Gd, Gd, Ch, Gd, Rr, Gd, Gd, Gd, Gd, Gd, Gd, Gd, Gd, Gd, Gd, Gd, Gd, Gd, Gd, Hhd, Md, Hhd^Fdf, Gd, Hhd, Gd, Gd, Gd, Gd, Gd, Gd, Gd, Gd, Gd, Gd, Hhd, Hhd, Hhd, Gd, Hhd, Hhd, Hhd, Hhd
Gd, Gd, Gd, Gd^Vct, Gd^Vct, Gd, Gd, 3 Kh^Vov, Ch, Ch, Gd, Gd, Gd, Gd, Gd, Gd, Gd, Gd, Gd, Gd, Gd, Gd, Gd, Hhd, Gd, Hhd, Gd, Gd, Gd, Gd, Gd, Gd, Gd, Gd, Gd, Gd, Gd, Gd, Hhd, Md, Md, Hhd, Hhd, Md, Md, Md
Gd, Gd, Gd, Gd, Gg, Gd, Rr, Rr, Gd, Gd, Gd, Gd, Gd, Gd, Gd, Gd, Gd, Gd, Gd, Gd, Gd, Gd, Gd, Gd, Gd, Gd, Gd, Gd, Gd, Gd, Gd, Gd, Gd, Gd, Gd, Gd, Gd, Hhd, Hhd, Hhd, Md, Md, Md, Md, Md, Md
