Urb, Xos, Xos, Xos, Xos, Xos, Xos, Xos, Xos, Xos, Xos, Xos, Xos, Xos, Xos, Xos, Xos, Xos, Xos, Xos, Xos, Xos, Xos, Xos, Xos, Xos, Xos, Xos, Xos, Xos, Xos, Xos, Xos, Xos, Xos, Xos, Xos, Xos, Xos, Xos, Xos, Xos, Xos, Xos, Xos, Xos, Xos, Xos, Xos, Xos, Xu, Xos, Xos
Urb, Urb, Urb, Xos, Xos^Efs, Xos, Urb^Es, Xos, Xos, Xos, Xos, Xos, Xos, Xos, Wwf, Xos, Xos, Xos, Urb, Urb^Edb, Urb, Xos, Xos, Xos, Xos, Xos, Xos, Xos, Xos, Xos, Xos, Xos, Xos, Xos, Urb^Em, Xos, Uu, Xos, Xos, Xos, Xos, Xos, Sm, Xos, Xos, Xos, Xu, Xos, Xu, Xu, Xu, Xu, Xos
Xos, Urb, Urb, Urb, Urb, Urb, Urb, Urb, Urb, Xos, Xos, Xos, Wwf, Sm, Urb, Urb, Urb, Xos^Efs, Rr^Pr\, Urb, Urb, Uu, Xos, Xos, Xos, Xos, Xos, Xos, Uu, Urb, Urb^Es, Xos, Xos^Efs, Urb, Urb, Urb, Urb, Uu, Xos, Xos, Xos^Efs, Uu, Urb, Uu, Urb^Em, Xos, Xos, Xu, Uu, Xu, Xu, Xu, Xos
Xos, Xos, Urb, Urb, Urb, Urb, Urb, Xos^Efs, Urb, Urb, Urb^Es, Xos, Urb, Urb, Urb, Urb, Urb, Urb, Urb, Xos, Xos, Xos, Uu, Uu, Urb, Xos, Xos, Xos, Xos^Efs, Urb, Urb, Urb, Urb, Rr^Pr\, Xos, Urb^Edb, Xos, Xos, Urb, Urb^Em, Urb, Rr^Pr\, Xos, Urb, Urb, Urb, Uu, Ur, Ur, Xuc, Uh, Xu, Xos
Xos, Urb^Es, Xos^Efs, Urb, Urb, Urb, Urb, Urb, Urb, Urb, Urb, Xos, Urb, Urb, Xos, Xos, Xos^Efs, Urb, Urb, Urb, Xos, Xos, Xos, Urb, Rr^Pr/, Xos, Sm, Wwf, Urb, Urb, Xos, Urb, Urb, Urb, Uu, Xos, Sm, Urb, Urb, Urb, Urb, Urb, Xos, Xos, Xos, Xos, Xu, Xu, Uu, Uu^Ii, Uu^Uf, Xu, Xos
Xos, Urb, Urb, Urb, Xos, Urb, Urb, Xos, Urb, Urb, Urb, Xos^Efs, Urb, Urb, Xos, Sm, Urb, Urb, Urb, Urb, Urb, Xos^Efs, Urb^Em, Xos, Urb, Urb, Urb, Urb, Urb, Urb, Xos, Xos, Xos, Urb, Xos, Xos, Urb, Urb, Urb, Urb, Xos, Xos, Urb, Sm, Uh, Xos, Xos, Xu, Uh, Uu, Xuc, Xu, Xos
Xos, Xos, Xos, Urb, Urb, Urb, Urb, Urb, Urb, Urb, Urb, Urb, Urb, Urb, Xos, Urb^Em, Urb, Urb, Xos, Urb, Urb, Urb, Urb, Urb, Urb, Urb, Urb, Urb, Xos, Xos, Sm, Wwf, Urb, Xos, Xos, Xos, Urb^Es, Urb, Urb, Xos^Efs, Rr^Pr\, Urb, Urb, Uu, Xos, Xos, Xos, Xos, Xos, Ur, Xu, Xu, Xos
Xos, Xos, Xos, Xos, Xos, Urb, Urb^Es, Urb, Xos, Urb, Urb, Urb, Urb, Urb, Xos, Urb, Urb, Xos, Xos^Efs, Xos, Urb, Urb, Urb, Urb, Xos, Urb, Urb, Urb, Urb, Xos^Efs, Rr^Pr\, Urb, Urb, Urb, Xos, Xos, Xos, Urb, Urb, Urb, Urb, Xos, Xos, Xos, Xos, Xos, Urb, Urb, Urb, Uu, Xos, Xu, Xos
Xos, Xos, Urb, Urb^Em, Urb, Xos, Xos, Xos, Xos, Urb, Urb, Urb, Xos^Efs, Xos^Efs, Urb, Urb, Urb, Urb, Urb, Urb, Urb, Urb, Xos, Xos, Xos, Xos, Urb^Es, Urb, Urb, Urb, Urb, Xos, Xos, Urb, Xos, Xos, Xos, Xos, Xos, Urb, Urb, Urb, Urb, Xos, Xos, Urb, Urb, Urb, Urb, Urb, Urb, Xos, Xos
Xos, Uu, Urb, Urb, Rr^Pr/, Xos, Xos, Xos, Uu, Urb, Urb, Xos, Urb, Urb, Urb, Urb, Urb, Urb, Urb, Urb, Xos, Rr^Pr/, Urb, Urb^Es, Xos, Xos, Urb, Urb, Urb, Urb, Xos, Xos, Xos, Xos, Xos, Xos, Uu, Xos, Sm, Xos, Xos, Urb, Urb, Urb^Em, Xos, Xos, Urb, Urb, Urb, Urb, Xos, Xos, Xos
Xos, Sm, Xos, Xos^Efs, Urb, Urb, Urb, Xos, Urb, Urb, Urb, Urb, Urb, Urb, Urb, Urb, Wwf, Sm, Xos, Xos, Urb, Urb, Urb, Urb, Xos, Xos, Urb, Urb, Urb, Xos, Urb, Urb, Urb, Xos, Xos, Urb, Urb, Urb^Em, Urb, Wwf, Xos, Urb, Urb, Urb, Urb, Xos^Efs, Rr^Pw\, Urb, Xos, Xos, Xos, Xos, Xos
Xos, Xos, Xos, Uu, Urb, Urb, Urb, Xos^Efs, Urb, Urb, Xos, Xos, Urb, Urb, Urb, Sm, Xos, Xos, Xos, Uu, Uu, Uu, Xos^Efs, Xos^Efs, Urb, Urb, Urb, Urb, Xos, Xos^Efs, Rr^Pr\, Urb, Uu, Xos, Urb, Urb, Urb, Urb, Urb, Urb, Urb, Xos, Xos^Efs, Urb, Urb, Urb, Urb, Xos, Xos, Xos, Xos, Xos, Xos
Xos, Xos, Xos, Xos, Xos, Urb, Urb, Urb^Es, Urb, Urb, Urb, Xos^Efs, Urb, Urb, Xos, Xos, Urb^Edb, Uu, Urb, Xos, Xos^Efs, Xos, Urb, Urb, Urb, Urb, Sm, Xos, Urb, Urb, Xos^Efs, Xos, Xos, Xos, Urb, Urb, Urb, Xos, Xos^Efs, Urb, Urb, Urb, Urb, Urb, Urb, Urb, Rr^Pr/, Xos, Urb, Uu, Uu, Xos, Xos
Xos, Xos, Xos, Xos, Uu, Xos, Rr^Pr\, Urb, Urb, Urb, Urb, Urb, Urb, Urb, Urb, Xos, Xos, Urb, Rr^Pr/, Xos, Urb, Urb, Urb, Urb, Sm, Wwf, Xos, Xos, Urb, Urb, Urb, Xos, Xos^Efs, Xos, Urb, Urb, Urb, Urb, Urb, Xos^Efs, Xos, Urb, Urb, Urb, Urb, Xos, Xos^Efs, Urb, Urb, Urb, Urb^Edt, Urb^Em, Xos
Xos, Xos, Xos, Uu, Urb^Es, Urb, Urb, Xos, Xos, Xos, Xos, Sm, Wwf, Urb, Urb, Urb, Urb, Xos^Efs, Urb, Urb, Urb, Urb, Urb, Urb, Xos, Xos, Urb, Urb, Urb, Urb, Urb, Urb, Urb, Urb, Urb, Urb, Sm, Urb, Urb, Urb, Urb^Em, Xos, Wwf, Urb, Urb, Urb, Urb, Xos^Efs, Xos, Uu, Xos, Xos, Xos
Xu, Xu, Xu, Xos, Xos, Uu, Xos, Xos, Xos, Xos, Uu, Xos, Xos, Sm, Urb, Urb, Urb, Urb, Urb, Urb, Urb, Urb, Xos, Xos, Xos, Urb, Urb, Urb, Wwf, Sm, Xos, Urb, Urb, Urb, Urb, Xos, Xos, Sm, Wwf, Urb, Urb, Xos, Xos, Sm, Sm, Urb, Urb, Urb, Urb, Xos^Efs, Xos^Efs, Xos, Xos
Xu, Xu, Ss, Xu, Xu, Xos, Xos, Xos, Xos, Uu, Urb, Urb, Urb, Xos, Xos^Efs, Urb, Urb, Urb, Urb, Urb, Urb, Urb, Xos^Efs, Xos, Urb, Urb, Urb, Urb, Sm, Xos, Xos, Xos, Sm, Urb, Urb, Xos, Xos, Xos, Xos, Urb, Urb, Urb, Urb, Xos, Xos, Urb, Urb, Urb, Urb, Urb, Sm, Xos, Xos
Xu, Ss, Ur, Sm^Edt, Ur, Xu, Xu, Xos, Xu, Xos, Xos, Urb, Xos, Rr^Pr/, Urb, Urb^Em, Urb, Urb, Xos, Urb, Urb, Urb, Urb, Urb, Urb, Urb, Urb, Urb, Urb, Xos, Xos^Efs, Xos, Sm, Urb, Urb, Xos, Uu, Uu, Urb, Xos, Xos, Urb, Urb, Urb, Xos^Efs, Urb, Urb, Urb, Xos, Urb, Urb, Sm, Xos
Xu, Sm^Em, Sm, Xuc, Xuc, Uu, Uu, Xu, Uh, Xu, Xu, Xos, Xos, Urb, Urb, Urb, Rr^Pr/, Xos, Uu, Xos, Xos, Urb, Urb, Urb, Xos, Xos, Xos, Urb, Urb, Urb, Urb, Sm, Urb, Urb, Urb, Xos^Efs, Xos, Urb, Urb, Xos, Rr^Pr\, Urb, Urb, Urb, Urb, Urb, Urb, Urb, Xos, Xos, Urb^Em, Sm, Xos
Xu, Uh, Xu, Sm, Ur^Es, Xu, Sm, Ur^Es, Xu, Xu, Ss, Xu, Xu, Xos, Xos, Xos, Urb, Urb, Urb, Urb, Urb^Edb, Xos, Xos, Xos, Rr^Pr\, Uu, Xos, Xos, Urb, Urb, Urb^Em, Urb^Em, Urb, Urb, Urb, Urb, Xos^Efs, Uu, Urb, Urb, Xos, Xos^Efs, Urb, Urb, Urb, Urb, Urb, Urb, Xos^Efs, Xos, Urb^Em, Urb, Xos
Ur, Xu, Uu, Uh, Uu, Xu, Xu, Sm, Xu, Uh, Xuc, Sm^Edt, Sm^Em, Xu, Xu, Xos, Xos, Urb^Em, Uu, Uu, Xos, Xos, Urb, Urb, Urb, Xos, Xos^Efs, Urb, Urb, Urb, Xos, Xos, Xos, Urb, Urb, Urb, Urb, Xos^Efs, Xos, Xos, Xos^Efs, Urb, Urb, Urb, Xos, Urb, Urb, Urb, Urb, Urb, Urb, Uu, Xos
Xu, Ur^Edt, Qxu, Uu^Em, Qxu, Xu, Ss, Sm, Xu, Xu, Uh, Sm, Ur, Xu, Xu, Xu, Xu, Xos, Xos, Xos, Rr^Pr\, Urb, Urb, Urb, Urb, Urb, Urb, Urb, Urb, Xos, Xos, Xos, Xos, Xos, Urb, Urb, Urb, Urb^Em, Xos^Efs, Xos, Urb, Urb, Urb, Urb, Xos, Urb, Urb, Urb, Urb, Urb, Xos, Xos, Xos
Xu, Xuc, Ss, Qxu^Ii, Sm, Xu, Xuc, Ur, Uu, Xu, Xu, Xu, Xu, Ur^Edt, Ur, Ss, Sm, Xuc, Ur, Urb^Em, Urb, Xos, Xos, Xos, Xos, Urb, Urb^Em, Urb, Xos, Xos, Uu, Xos, Xos, Xos^Efs, Urb, Urb, Urb, Urb, Urb, Urb, Urb, Urb, Xos, Xos, Urb, Rr^Pr\, Xos, Urb, Xos, Rr^Pr/, Urb, Xos, Xos
Xu, Uu^Uf, Sm, Sm, Xu, Ur, Ur^Edb, Uu, Uu, Xuc, Ur, Ur^Em, Sm^Edt, Xuc, Ss, Ss, Xu, Ur, Sm, Sm, Xos, Xos, Xos, Xos, Xos, Xos, Xos, Xos, Xos, Uu, Urb, Urb, Urb, Rr^Pr\, Xos, Urb, Urb, Urb, Urb, Urb, Xos, Xos, Xos, Uu, Urb, Urb, Urb, Xos, Uu, Urb, Urb, Urb, Xos
Xu, Ur^Em, Uh, Xuc, Xu, Xu, Xu, Xu, Xu, Ur, Sm, Xu, Uh, Sm, Xu, Xu, Xu, Uh, Xu, Xu, Xos, Xos, Xos, Xos, Xos, Xos, Xos, Xos, Xos, Urb, Urb, Urb, Xos, Xos, Xos, Xos, Xos, Urb, Xos, Xos, Xos, Xos, Xos, Uu, Urb^Edt, Urb, Xos, Xos, Xos, Urb, Sm, Uu, Xos
Xu, Xu, Xu, Xu, Xu, Xu, Xu, Xu, Xu, Xu, Xu, Xu, Xu, Xu, Xu, Xu, Xu, Xu, Xos, Xos, Xos, Xos, Xos, Xos, Xos, Xos, Xos, Xos, Xos, Xos, Xos, Xos, Xos, Xos, Xos, Xos, Xos, Xos, Xos, Xos, Xos, Xos, Xos, Xos, Xos, Xos, Xos, Xos, Xos, Xos, Xos, Xos, Xos
