border_size=1
usage=map

Md^Xm, Gg, Md, Md, Hhd, Gs^Fds, Gs^Fds, Gs^Fds, Gs^Fds, Gs^Fds, Gs^Fds, Gs^Fds, Rrc, Gs^Fds, Gs^Fds, Gs^Fds, Gs^Fds, Gs^Fds, Gs^Fds, Gs^Fds, Gs^Fds, Gs^Fds, Gs^Fds
Md^Xm, Md^Xm, Md, Md, Hhd, Gs^Fds, Gs^Fds, Gs^Fds, Gs^Fds, Gs^Fds, Gs^Fds, Gs^Fds, Rrc, Gs^Fds, Gs^Fds, Gs^Fds, Gs^Fds, Gs^Fds, Gs^Fds, Gs^Fds, Gs^Fds, Gs^Fds, Gs^Fds
Md^Xm, Md^Xm, Md, Md, Md, Hhd, Qxu, Qxu, Qxu, Qxu, Qxu, Qxu, Qxu^Bh|, Qxu, Qxu, Qxu, Qxu, Md, Qxu, Md, Md, Md, Md
Md^Xm, Md^Xm, Md, Md, Md, Md, Qxu, Qxu, Uh, Qxu, Qxu, Qxu, Qxu^Bh|, Qxu, Uh, Qxu, Qxu, Qxu, Qxu, Qxu, Md, Md, Md
Md^Xm, Md^Xm, Md^Xm, Md, Mm, Mm, Md, Uh, Md, Md, Hhd, Hhd, Rrc, Uh, Hhd^Vhhr, Uh, Uh, Uh, Gs^Fms, Qxu, Gs^Fms, Md, Gs^Fms
Md^Xm, Md^Xm, Md^Xm, Md^Xm, Mm, Md, Md, Md, Md, Hhd, Hhd, Hhd, Rrc, Hhd, Hhd, Gs^Fms, Gs^Fms, Gs^Fms, Gs^Fms, Gs^Fms, Gs^Fms, Gs^Fms, Gs^Fms
Md^Xm, Md^Xm, Md^Xm, Md^Xm, Mm, Md, Md, Md, Hhd, Hhd, Hhd, Gs^Vl, Rrc, Hhd, Hhd, Gs^Fms, Gs^Fms, Gs^Fms, Gs^Fms, Gs^Fms, Gs^Fms, Gs^Fms, Gs^Fms
Md^Xm, Md^Xm, Md^Xm, Md^Xm, Md, Md, Md, Md, Gg^Edb, Gd^Vhr, Rp, Rp, Rp, Gs^Vc, Hhd, Gs^Fms, Gs^Fms, Gs^Fms, Gs^Fms, Gs^Fms, Gs^Fms, Gs^Fms, Gs^Fms
Md^Xm, Md^Xm, Md^Xm, Md^Xm, Md^Xm, Md, Md, Hhd, Rp, Rp, Chr^Cov, Gg^Edb, Chr^Cov, Rp, Rp, Gg^Edb, Gg^Edb, Gs^Fms, Hhd, Gs^Fms, Gs^Fms, Gs^Fms, Gs^Fms
Md^Xm, Md^Xm, Md^Xm, Md^Xm, Md^Xm, Md, Hhd, Gd^Vhr, Rp, Gg^Edb, Rp, 1 Khr^Kov, Rp, Rp, Gg^Edb, Gd^Vhr, Gg^Edb, Gg^Edb, Hhd, Hhd, Gs^Fms, Gs^Fms, Wo
Md^Xm, Md^Xm, Md^Xm, Md^Xm, Md, Md, Hhd, Gg^Edb, Rp, Gs^Vc, Rp, Rp^Ecf, Rp, Gs^Vl, Hhd, Gg^Edb, Gg^Edb, Gg^Edb, Hhd, Hhd, Wo, Wo, Wo
Md^Xm, Md^Xm, Md^Xm, Md^Xm, Md, Hhd, Hhd, Gd^Vhr, Rp, Rp, Gs^Vh, Rp, Gg^Gvs, Gg^Gvs, Gg^Gvs, Gg^Edb, Ss, Ss, Ww, Wo, Wo, Wo, Wo
Md^Xm, Md^Xm, 2 Md^Xm, Md^Xm, Md, Hhd, Hhd, Gg^Eff, Gg^Eff, Rp, Rp, Gg^Gvs, Gg^Gvs, Gg^Wm, Gg^Gvs, Gg^Gvs, Ww, Ss, Wot, Wo, Gll^Fmf, Wo, Gll^Fmf
Md^Xm, Md^Xm, Md^Xm, Md^Xm, Mm^Xm, Mm^Xm, Mm, Gg^Edb, Gg^Edb, Gg^Edt, Rp, Gg^Edt, Gg^Esd, Gg^Gvs, Ww^Ewl, Ww, Ww, Wot, Gll^Fdf, Gll^Fmf, Gs^Fds, Gs^Fds, Gs^Fds
Md^Xm, Md^Xm, Md^Xm, Md^Xm, Mm^Xm, Mm, Mm, Hh, Gs^Fms, Gg^Edt, Ss, Rp, Ww, Ww, Ww, Ww, Hh^Vhh, Gll^Fmf, Gll^Fmf, Gll^Fdf, Gs^Fds, Gs^Fds, Gs^Fds
Md^Xm, Md^Xm, Md^Xm, Mm^Xm, Md, Mm, Hh, Hh, Ww, Ww, Wwf, Wot^Bw|r, Ww, Wot, Ss, Hh, Gs^Fms, Hh, Gll^Fmf, Gll^Fdf, Gs^Fds, Gs^Fds, Gs^Fds
Md^Xm, Md^Xm, Wo, Wot, Wot, Hh, Ww, Ww, Ss, Ss, Gs^Fms, Gll, Gs^Fms, Ss, Gs^Fms, Gs^Fms, Gs^Fms, Hh, Gll^Fmf, Gll^Fdf, Gs^Fds, Gs^Fds, Gs^Fds
Md^Xm, Md^Xm, Md^Xm, Wot, Wot, Wo, Gs^Fds, Gs^Fds, Gs^Fds, Gs^Fds, Gs^Fms, Gs^Edb, Gs^Fms, Gs^Fms, Gll^Fp, Gll^Fp, Gll^Fp, Gll^Fmf, Gll^Fmf, Gll^Fdf, Gs^Fds, Gs^Fds, Gs^Fds
Md^Xm, Md^Xm, Md^Xm, Md^Xm, Ss, Gs^Fds, Gs^Fds, Gs^Fds, Gs^Fms, Gs^Fms, Gs^Fms, Gs^Fms, Gs^Fms, Gll^Fp, Gll^Fp, Gll^Fp, Gll^Fp, Gll^Fmf, Gll^Fmf, Gll^Fdf, Gs^Fds, Gs^Fds, Gs^Fms
Md^Xm, Md^Xm, Md^Xm, Md^Xm, Gll^Fp, Gll^Fp, Gs^Fds, Gs^Fds, Gs^Fms, Gs^Fms, Gs^Fms, Gs^Fms, Gs^Fds, Gll^Fp, Gll^Fp, Gll^Fp, Gll^Fp, Gll^Fmf, Gll^Fmf, Gll^Fmf, Gll^Fp, Gll^Fmf, Gll^Fmf
Md^Xm, Md^Xm, Md^Xm, Gll^Fp, Gll^Fp, Gll^Fp, Gll^Fp, Gs^Fds, Gll^Fp, Gs^Fms, Gs^Fds, Gs^Fds, Gs^Fds, Gll^Fp, Gs^Fds, Gll^Fp, Gs^Fds, Gll^Fmf, Gll^Fmf, Gll^Fdf, Gll^Fmf, Gll^Fmf, Gll^Fmf
