Ss, Gs, Gs, Gs, Ss, Ss, Ss, Ss, Gs, Gs, Gs, Ss, Ss, Gs, Gs, Gs, Ww, Ww, Gs, Uh, Xu, Xu, Xu
Gs, Gs^Ft, Gs^Ft, Ss, Ss, Ss, Gs^Ft, Ss, Ss, Gs, Gs, Gs^Ft, Gs, Ss^Vhs, Gs, Gs^Ft, Ww, Ww, Gs^Ft, Uh, Xu, Xu, Xu
Ww, Ww, Gs, Gs, Gs, Gs, Gs, Ss, Gs, Ss, Gs, Gs, Gs, Gs, Ww, Gs, Gs, Gs, Gs, Uu^Uf, Uu^Vu, Xu, Xu
Xu, Xu, Gs, Ww, Ww, Ww, Ww, Gs, Gg, Gs, Ww, Ww, Ww, Ww, Gs, Gs, Ww, Gs, Xu, Rb, Rb, Cud, Ss
Xu, Xu, Gs, Gs, Gs, Ww, Gs, Wo, Gg, Wo, Gs, Ww, Gs, Gs, Gs, Ww, Ww, Gs, Rb, Ss, Rb, Rb, Ss
Gs, Gs^Ft, Gs, Ww, Ww, Gs, Gs, Gg, Gg, Gg, Gs, Gs, Ww, Ww, Ww, Gs, Gs, Gs, Rb, Rb, Rb, Rb, Rb
Ww, Ww, Ww, Gs, Gs, Ww, Gs, Gs, Wwf, Gs, Gs, Gs, Gs, Gs, Ww, Ww, Gs, Xu, Rb, Rb, Rb, Rb, Xu
Gs, Gs, Ww, Gs, Ww, Gs, Gd, Gd, Uu^Vud, Gd, Gd, Hh, Gg, Gs, Gs, Gs, Gg, Xu, Xu, Rb, Xu, Rb, Xu
Ww, Ww, Gs, Ww, Gs, Gs, Gd^Ft, Xu, Xu, Xu, Gd, Gg, Gg, Gg, Gs, Gd, Ss^Vhs, Gg, Ww, Xu, Xu, Rb, Ww
Gs, Gs, Gs^Vht, Gs, Gs, Gs, Gs, Cud, Wwf, Wwf, Wwf, Gs, Gs, Gs, Gs, Gd, Gd, Gs, Gs, Rb, Wwf, Ww, Ww
Ww, Gs^Ft, Wwf, Gg, Re^Uf, Gs, Wwf, Wwf, Ss^Vhs, Gs^Ft, Gs, Wwf, Gs, Re, Re^Ft, Gs, Gs, Gs, Ww, Xu, Uh, Uh, Xu
Gs, Ww, Xu, Gg, Re, Gs, Wwf, Ss, Gs, Re, Re, Wwf, Gs, Mm, Re^Ft, Re, Gs, Gs^Ft, Uh, Xu, Xu, Uh, Xu
Ww, Gs^Ft, Xu, Re^Ft, Re, Gs, Gs, Wwf, Wwf, Gs, Wwf, Wwf, Wwf, Gs, Gs, Re, Re^Uf, Gd, Gg, Xu, Xu, Gs^Ft, Gs^Ft
Uh, Ww, Xu, Rb, Xu, Re, Re, Gs, Wwf, Wwf, Hh, Hh^Uf, Gs, Wwf, Wwf, Uh, Gg, Re^Ft, Gg, Re^Ft, Xu, Uh, Xu
Xu, Uh, Xu, Uu^Uf, Rb, Xu, Rb, Gs, Wwf, Gs^Ft, Gs, Mm, Hh, Gs^Ft, Wwf, Gs, Re, Xu, Xu, Uu^Uf, Xu, Uh, Uh
Gs, Uh, Xu, Re^Ft, Rb, Re^Ft, Re^Uf, Uh, Gs, Wwf, Wwf, Hh^Uf, Wwf, Wwf, Wwf, Gs, Gs, Re, Re, Gg, Xu, Ww, Ww
Xu, Gs^Ft, Xu, Xu, Uh, Gd, Gs, Re, Re^Ft, Gs, Gs, Wwf, Gs, Gs, Gs, Wwf, Wwf, Gs, Re, Re^Ft, Xu, Gs^Ft, Gs^Ft
Xu, Uh, Uh, Xu, Ww, Gs^Ft, Gs, Re, Re^Ft, Mm, Gs, Wwf, Gs, Re, Ss^Vhs, Ss, Wwf, Gs, Re^Uf, Gg, Wwf, Ww, Ww
Ww, Uh, Wwf, Xu, Gs, Gs, Gd, Gs, Gs, Re, Gs, Wwf, Wwf, Gs^Ft, Wwf, Wwf, Gs, Gs, Re, Gg, Gs^Vht, Gs^Ft, Gs
Ww, Ww, Xu, Gg, Ww, Gg, Ss^Vhs, Gd, Gs, Gs, Gg, Gs, Gd, Wwf, Xu, Gg, Gd^Ft, Gs, Gs, Gs, Gs, Gs, Gs
Xu, Uh, Xu, Xu, Xu, Gg, Gg, Gd, Gs, Gg, Gg, Gg, Gd, Xu, Uu^Vud, Xu, Gd, Gs, Ww, Ww, Ww, Ww, Ww
Xu, Rb, Rb, Rb, Rb, Xu, Gs, Gs, Ww, Gs, Gs, Hh, Gs, Gd, Wwf, Gd, Gs, Gs, Gs, Gs, Ww, Gs, Gs
Rb, Rb, Uu^Vud, Rb, Rb, Xu, Gs, Ww, Ww, Gs, Ww, Gs, Gs, Mm^Xm, Gg, Gs, Gs, Ww, Ww, Gs, Gs, Ww, Ww
Ss, Rb, Rb, Rb, Rb, Gs, Ww, Gs, Gs, Ww, Gs, Gs, Gs, Gg, Gg, Gg, Gs, Gs, Gs, Ww, Gs, Gs^Ft, Gs
Ss, Rb, Rb, Ss, Xu, Gs, Ww, Ww, Gs, Gs, Ww, Ww, Ww, Wo, Gg, Wo, Ww, Ww, Ww, Gs, Gs, Xu, Xu
Cud, Rb, Uu^Vu, Rb, Gs, Gs, Gs, Gs, Ww, Ww, Gs, Ww, Gs, Gs, Gs, Gs, Gs, Ww, Gs, Ww, Gs, Xu, Xu
Xu, Xu, Xu, Uu^Uf, Gs^Ft, Gs, Ww, Gs, Gs, Gs, Gs, Gs, Gs, Ss, Ss, Ss, Gs, Gs, Ss, Gs, Gs^Ft, Ww, Ww
Xu, Xu, Xu, Uh, Xu, Ww, Gs^Ft, Gs, Ss, Ss^Vhs, Ss, Gs^Ft, Gs, Gs, Ss, Gs, Gs^Ft, Ss, Ss, Ss, Ss, Uh, Uh
Ww, Ww, Ww, Xu, Xu, Xu, Ss, Gs, Ss, Xu, Xu, Xu, Ss, Ss, Gs, Xu, Xu, Xu, Xu, Gs^Ft, Ss, Xu, Xu
Ww, Ww, Ww, Xu, Xu, Xu, Ss, Xu, Ss, Xu, Xu, Xu, Ss, Ss, Gs, Xu, Xu, Xu, Xu, Gs, Ss, Xu, Xu
