border_size=1
usage=map

Gg, Gg, Gg, Gg, Gg, Gg, Gg, Gg, Gg, Gg, Gg, Gg, Gg, Gg, Gg, Gg, Gg, Gg, Gg, Gg
Gg, Gg, Gg, Gg, Gg, Gg, Gg, Gg, Gg, Gg, Gg, Gg, Gg, Gg, Gg, Gg, Wog^Bw|, Gg, Wog, Gg
Gg, Gg, Gg, Gg, Gg, Gg, Gg, Gg, Gg, Gg, Gg, Gg, Rr, Gg, Gg, Wog, Wog^Bw|, Wog, Wog, Gg
Gg, Gg, Gg, Gg, Gg, Gg, Gg, Gg, Qlf, Gg, Rr, Rr, Dd, Aa, Aa, Wwg, Wwg^Bw|, Wwg, Wwg, Gg
Gg, Gg, Gg, Gg, Gg, Gg, Gg, Qlf, 1 Gg, Qlf, Rr, Dd, Dd, Aa, Gg, 2 Wwg, Wwg^Bw|, Wwg, Wwrg, Gg
Gg, Gg, Gg, Gg, Gg, Gg, Gg, Qlf, Qlf, Qlf, Rr, Dd, Dd, Hd, Hd, Gg, Mm, Wwrg, Wwrg, Gg
Gg, Gg, Gg, Gg, Gg, Gg, Gg, Gg, Gg, Gll^Ftr, Gll^Ftr, Gll^Ftr, Gll^Ftr, Hd, Hd, Mm, Mm, Wwrg, Ss, Gg
Gg, Gg, Gg, Gg, Gg, Gg, Gg, Khs, Khs, Gg, Chw, Chw, Chw, Ss^Vhs, Ss^Vhs, Mm, Ss, Ss, Ss, Ss
Gg, Gg, Gg, Gg, Gg, Gg, Gg, Khs, Gg, Khs, Gg, Chw, Gg, Gg, Gg, Mm, Gg, Ss, Gg, Gg
Gg, Gg, Gg, Gg, Gg, Gg, Gg, Gg, Gg, Gg, Gg, Gg, Gg, Gg, Gg, Gg, Gg, Gg, Gg, Gg
Gg, Gg, Gg, Gg, Gg, Gg, Gg, Gg, Gg, Gg, Gg, Gg, Gg, Gg, Gg, Gg, Gg, Gg, Gg, Gg
Gg, Gg, Gg, Gg, Gg, Gg, Gg, Gg, Gg, Gg, Gg, Gg, Gg, Gg, Gg, Gg, Gg, Gg, Gg, Gg
Gg, Gg, Gg, Gg, Gg, Gg, Gg, Gg, Gg, Gg, Gg, Gg, Gg, Gg, Gg, Gg, Gg, Gg, Gg, Gg
Gg, Gg, Gg, Gg, Gg, Gg, Gg, Gg, Gg, Gg, Gg, Gg, Gg, Gg, Gg, Gg, Gg, Gg, Gg, Gg
Gg, Gg, Gg, Gg, Gg, Gg, Gg, Gg, Gg, Gg, Gg, Gg, Gg, Gg, Gg, Gg, Gg, Gg, Gg, Gg
Gg, Gg, Gg, Gg, Gg, Gg, Gg, Gg, Gg, Gg, Gg, Gg, Gg, Gg, Gg, Gg, Gg, Gg, Gg, Gg
Gg, Gg, Gg, Gg, Gg, Gg, Gg, Gg, Gg, Gg, Gg, Gg, Gg, Gg, Gg, Gg, Gg, Gg, Gg, Gg
Gg, Gg, Gg, Gg, Gg, Gg, Gg, Gg, Gg, Gg, Gg, Gg, Gg, Gg, Gg, Gg, Gg, Gg, Gg, Gg
Gg, Gg, Gg, Gg, Gg, Gg, Gg, Gg, Gg, Gg, Gg, Gg, Gg, Gg, Gg, Gg, Gg, Gg, Gg, Gg
Gg, Gg, Gg, Gg, Gg, Gg, Gg, Gg, Gg, Gg, Gg, Gg, Gg, Gg, Gg, Gg, Gg, Gg, Gg, Gg
