Xos, Xos, Xos, Xos, Xos, Xos, Xos, Xos, Xos, Xos, Xos, Xos, Xos, Xos, Xos, Xos, Xos, Xos, Xos, Xos, Xos, Xos, Xos, Xos, Xos, Xos, Xos, Xos, Xos, Xos, Xos, Xos, Xos, Xos, Xos, Xos, Xos, Xos, Xos, Xos, Xos, Xos, Xos, Xos, Xos, Xos, Xos, Xos, Xos, Xos, Xos, Xos, Xos
Xos, Urb, Urb, Urb, Urb, Urb, Urb, Urb, Urb, Urb, Urb, Urb, Urb, Urb, Urb, Urb, Urb, Urb, Urb, Urb, Xos, Urb, Urb, Urb, Urb, Urb, Urb, Xos, Xos, Xos, Urb, Urb, Xos, Urb, Urb, Xos, Xos, Xos, Urb, Urb, Xos, Urb, Urb, Urb, Urb, Urb, Urb, Urb, Urb, Urb, Urb, Urb, Xos
Xos, Urb, Urb, Urb, Urb, Urb, Urb, Urb, Urb, Urb, Urb, Urb, Urb, Urb, Urb, Urb, Urb, Urb, Urb, Urb, Xos, Urb, Urb, Urb, Urb, Urb, Xos, Xos, Xos, Xos, Xos, Urb, Xos, Urb, Xos, Xos, Xos, Xos, Rr^Pr\, Urb, Xos, Urb, Urb, Urb, Urb, Urb, Urb, Urb, Urb, Urb, Urb, Urb, Xos
Xos, Rr^Pr\, Xos, Xos, Xos, Xos, Xos, Xos, Xos, Urb, Urb, Xos, Xos, Xos, Xos, Xos, Xos, Xos, Xos, Xos, Urb, Xos, Xos, Xos, Xos, Rr^Pr/, Urb, Xos, Urb, Xos, Urb, Rr^Pr\, Xos, Rr^Pr/, Urb, Xos, Urb, Urb, Urb, Xos, Urb, Urb, Urb, Urb, Xos, Urb, Xos, Urb, Xos, Urb, Urb, Urb, Xos
Xos, Urb, Urb, Xos, Xos, Xos, Urb, Urb, Urb, Urb, Urb, Urb, Urb, Urb, Urb, Urb, Urb, Urb, Urb, Urb, Urb, Urb, Urb, Urb, Urb, Urb, Urb, Urb, Urb, Urb, Urb, Urb, Urb, Urb, Urb, Urb, Urb, Urb, Urb, Urb, Urb, Urb, Urb, Xos, Xos, Xos, Xos, Xos, Xos, Xos, Urb, Urb, Xos
Xos, Urb, Urb, Urb, Urb, Xos, Xos, Urb, Urb, Urb, Urb, Urb, Xos, Urb, Xos, Urb, Xos, Urb, Urb, Urb, Urb, Urb, Urb, Urb, Urb, Urb, Urb, Urb, Urb, Urb, Urb, Urb, Urb, Urb, Urb, Urb, Urb, Urb, Urb, Urb, Urb, Urb, Urb, Xos, Xos, Xos, Urb, Urb, Urb, Urb, Urb, Urb, Xos
Xos, Urb, Urb, Urb, Urb, Urb, Xos, Urb, Urb, Urb, Urb, Urb, Urb, Xos, Xos, Xos, Xos, Xos, Urb, Urb, Xos, Xos, Xos, Xos, Xos, Xos, Xos, Xos, Xos, Xos, Xos, Xos, Xos, Xos, Xos, Xos, Xos, Xos, Xos, Xos, Xos, Urb, Urb, Urb, Xos, Urb, Urb, Urb, Urb, Urb, Xos, Xos, Xos
Xos, Urb, Urb, Urb, Urb, Urb, Xos, Urb, Urb, Xos, Xos, Urb, Urb, Urb, Urb, Xos, Urb, Urb, Urb, Urb, Urb, Urb, Urb, Xos, Urb, Urb, Urb, Urb, Urb, Xos, Urb, Urb, Urb, Urb, Urb, Urb, Urb, Urb, Urb, Xos, Xos, Xos, Urb, Urb, Xos, Urb, Urb, Urb, Xos, Xos, Xos, Xos, Xos
Xos, Urb, Urb, Urb, Urb, Urb, Xos, Urb, Urb, Urb, Rr^Pr/, Xos, Xos, Urb, Urb, Xos, Urb, Urb, Urb, Urb, Urb, Urb, Urb, Xos, Urb, Urb, Urb, Urb, Urb, Xos, Urb, Urb, Xos, Urb, Urb, Urb, Xos, Urb, Urb, Urb, Urb, Urb, Urb, Urb, Xos, Urb, Urb, Xos, Xos, Xos, Xos, Xos, Xos
Xos, Urb, Urb, Urb, Xu, Xos, Xos, Urb, Urb, Xos, Urb, Urb, Xos, Urb, Urb, Xos, Xos, Urb, Urb, Urb, Urb, Urb, Urb, Xos, Xos, Urb, Urb, Urb, Urb, Xos, Urb, Urb, Xos, Xos, Xos, Xos, Xos, Xos, Xos, Urb, Urb, Urb, Xos, Xos, Urb, Urb, Urb, Xos, Xos, Xos, Xos, Xos, Xos
Xos, Urb, Xu, Urb, Xu, Xos, Xos, Urb, Urb, Xos, Urb, Urb, Xos, Urb, Urb, Urb, Urb, Xos, Xos, Urb, Urb, Urb, Urb, Urb, Urb, Rr^Pr\, Xos, Urb, Xos, Xos, Urb, Urb, Urb, Urb, Urb, Urb, Urb, Urb, Urb, Xos, Xos, Xos, Urb, Urb, Urb, Urb, Xos, Xos, Xos, Xos, Xos, Xos, Xos
Xos, Xu, Xu, Urb, Xu, Xos, Xos, Urb, Urb, Xos, Xos, Xos, Rr^Pr\, Urb, Urb, Urb, Urb, Urb, Urb, Xos, Urb, Urb, Urb, Urb, Urb, Urb, Urb, Xos, Urb, Urb, Urb, Urb, Urb, Urb, Urb, Urb, Urb, Urb, Urb, Urb, Urb, Urb, Urb, Urb, Xos, Rr^Pr/, Urb, Urb, Urb, Xos, Xos, Xos, Xos
Xos, Xos, Xu, Urb, Urb, Urb, Xos, Urb, Urb, Xos, Urb, Urb, Xos, Xos, Rr^Pr\, Urb, Urb, Urb, Urb, Xos, Urb, Urb, Xos, Xos, Xos, Urb, Urb, Xos, Urb, Urb, Urb, Urb, Urb, Urb, Urb, Urb, Xos, Urb, Urb, Urb, Urb, Urb, Xos, Xos, Urb, Urb, Urb, Urb, Xos, Xos, Urb, Urb, Xos
Xos, Xos, Urb, Urb, Urb, Urb, Xos, Urb, Urb, Xos, Urb, Urb, Xos, Urb, Urb, Xos, Xos, Urb, Urb, Xos, Urb, Urb, Xos, Xos, Xos, Urb, Urb, Xos, Urb, Urb, Xos, Urb, Xos, Urb, Urb, Urb, Xos, Urb, Urb, Urb, Urb, Urb, Xos, Urb, Urb, Urb, Xos, Xos, Urb, Urb, Urb, Urb, Xos
Xos, Urb, Urb, Urb, Urb, Urb, Xos, Urb, Urb, Xos, Urb, Urb, Xos, Urb, Urb, Urb, Xos, Urb, Urb, Xos, Urb, Urb, Urb, Xos, Urb, Urb, Urb, Xos, Urb, Urb, Xos, Xos, Urb, Xos, Xos, Xos, Xos, Xos, Xos, Xos, Urb, Urb, Urb, Xos, Xos, Xos, Urb, Urb, Urb, Urb, Urb, Urb, Xos
Xos, Urb, Urb, Urb, Urb, Urb, Xos, Urb, Urb, Xos, Xos, Urb, Xos, Urb, Urb, Urb, Xos, Urb, Urb, Xos, Urb, Urb, Urb, Urb, Urb, Urb, Xos, Xos, Xos, Rr^Pr/, Urb, Urb, Urb, Urb, Urb, Xos, Xos, Xos, Xu, Xu, Xos, Urb, Urb, Urb, Urb, Urb, Urb, Urb, Xos, Xos, Urb, Urb, Xos
Xos, Urb, Urb, Urb, Urb, Urb, Xos, Urb, Urb, Urb, Urb, Xos, Xos, Urb, Urb, Urb, Xos, Urb, Urb, Urb, Urb, Urb, Urb, Urb, Xos, Urb, Urb, Urb, Rr^Pr/, Xos, Xos, Urb, Urb, Urb, Urb, Urb, Xu, Xu, Xu, Urb, Urb, Xos, Xos, Urb, Urb, Urb, Xos, Xos, Urb, Ss, Xu, Urb, Xos
Xos, Urb, Urb, Urb, Urb, Xos, Rr^Pw\, Urb, Urb, Urb, Urb, Xos, Urb, Xos, Xos, Xos, Urb, Urb, Urb, Urb, Urb, Urb, Urb, Xos, Urb, Urb, Xos, Xos, Urb, Urb, Urb, Xos, Xos, Urb, Xos, Xos, Urb, Ss, Urb, Xu, Xu, Ss, Urb, Xos, Xu, Xos, Xos, Ss, Xu, Xu, Ss, Urb, Xos
Xos, Urb, Urb, Urb, Urb, Urb, Urb, Xos, Urb, Urb, Urb, Xos, Urb, Urb, Urb, Urb, Urb, Urb, Urb, Xos, Urb, Urb, Urb, Xos, Rr^Pr/, Xos, Xos, Xos, Urb, Urb, Urb, Urb, Xos, Xos, Ss, Xu, Urb, Xu, Xu, Xu, Ss, Xu, Ss, Xu, Urb, Xu, Xu, Urb, Xos, Ss, Xu, Ss, Xos
Xos, Urb, Urb, Urb, Urb, Urb, Urb, Xos, Urb, Urb, Urb, Xos, Urb, Urb, Urb, Urb, Urb, Urb, Urb, Xos, Xos, Urb, Urb, Xos, Urb, Urb, Urb, Xos, Xos, Urb, Xos, Xos, Xu, Xu, Xu, Ss, Xu, Urb, Xu, Urb, Xu, Urb, Ss, Xu, Xu, Ss, Ss, Xu, Xu, Urb, Ss, Xu, Xu
Xos, Urb, Urb, Urb, Urb, Urb, Urb, Xos, Xos, Urb, Urb, Xos, Urb, Urb, Urb, Urb, Urb, Urb, Xos, Xos, Urb, Rr^Pr\, Xos, Xos, Urb, Urb, Urb, Xos, Xos, Xu, Ss, Ss, Ss, Urb, Xu, Urb, Xu, Urb, Urb, Urb, Xu, Urb, Urb, Ss, Urb, Urb, Xu, Ss, Ss, Xu, Xu, Urb, Xu
Xos, Urb, Urb, Urb, Urb, Urb, Urb, Xos, Xos, Rr^Pr|o, Xos, Xos, Xos, Rr^Pr|o, Xos, Urb, Xos, Rr^Pr/, Urb, Xos, Urb, Urb, Urb, Xos, Urb, Urb, Xos, Xos, Xu, Xu, Ss, Xu, Urb, Xu, Ss, Xu, Ss, Xu, Xu, Xu, Ss, Xu, Xu, Xu, Xu, Xu, Xu, Urb, Xu, Ss, Ss, Ss, Xu
Xos, Urb, Urb, Urb, Urb, Urb, Urb, Xos, Urb, Urb, Urb, Xos, Urb, Urb, Urb, Xos, Urb, Urb, Urb, Xos, Urb, Urb, Urb, Xos, Xu, Xos, Xu, Urb, Xu, Urb, Xu, Xu, Xu, Ss, Xu, Urb, Ss, Ss, Xu, Ss, Xu, Ss, Ss, Urb, Xu, Urb, Xu, Xu, Urb, Urb, Xu, Urb, Xu
Xos, Urb, Urb, Urb, Urb, Urb, Urb, Xos, Urb, Urb, Urb, Urb, Urb, Urb, Urb, Xos, Urb, Urb, Urb, Xos, Urb, Urb, Urb, Xos, Xu, Urb, Ss, Ss, Ss, Ss, Xu, Ss, Urb, Ss, Ss, Xu, Ss, Xu, Ss, Ss, Xu, Ss, Xu, Ss, Ss, Ss, Ss, Ss, Xu, Urb, Xu, Urb, Xu
Urb, Rr^Pw\, Xos, Urb, Xos, Urb, Xos, Xos, Xos, Urb, Xos, Urb, Xos, Urb, Xos, Xos, Xos, Urb, Xos, Xos, Xos, Urb, Xos, Xu, Ss, Urb, Xu, Xu, Xu, Xu, Xos, Xu, Xu, Xu, Xu, Xu, Xu, Ss, Xu, Urb, Xu, Urb, Xu, Urb, Xu, Urb, Xu, Ss, Xu, Urb, Xu, Urb, Xu
Xos, Xos, Xos, Xos, Xos, Xos, Xos, Xos, Xos, Xos, Xos, Xos, Xos, Xos, Xos, Xos, Xos, Xos, Xos, Xos, Xos, Xos, Xos, Xu, Ss, Xu, Xos, Xos, Xos, Xos, Xos, Xos, Xos, Xos, Xos, Xos, Xos, Xu, Xos, Xu, Xos, Xu, Xos, Xu, Xos, Xu, Xos, Xu, Xos, Xu, Xos, Xu, Xos
